000XXXX0XXX0000
XX000000000XX0X
X000X0XXXX00000
XXX0XXXXXX0XXX0
000000000000XX0
XXXXXX0XXXX0X00
XX000X00000XX0X
000X0XXX0X0XX0X
0X0000000X00000
0XX0X0XX0X0XXX0
0X0XXXXX0X0X000
0X0000X0000XXXX
0XXXX000X0X0000
0X000XXXX0X0XX0
0X0X000000000X0
